1111111111111
100100E000001
10P0011111001
1P0011E000001
1111111111111