1111111111111
10000000001C1
1010011110111
1P1011E000001
1111111111111