1111111111111
10010000000C1
100001111101
1P0011E000011
1111111111111