11111111111111111111111111
10010000000C110010000000C1
1E000111110000000011111001
1P00110000001100C011111001
11111111111111111111111111