1111111111111
10010CC0C00C1
100000C000001
1P0011E000001
1111111111111