11111111111111111111111111
10010000000C110010000000C1
10000111110000000011111111
1P00110000001100C0111110E1
11111111111111111111111111
